##########################
####       ))))       ####
####       ))))       ####
####       ((((       ####
#                        #
#                        #
            ))            
 S          ))          F 
            ))            
#                        #
#                        #
####       ((((       ####
####       ))))       ####
####       ))))       ####
##########################