###     ##################
#  N                     #
#                        #
###########))            #
###########))            #
#))))))))))))            #
#))))))))))))            #
#                        #
#           )))))~)))))))#
#           )))###########
#           )))###########
#           )))))))))))))#
#                        #
# S                      #
#   ######################