###     ##################
# #  N  )#)          )$))#
# #     )#)          ))))#
# #     )#)          ))))#
# #     )#)    ###       #
# #     )#)    ###       #
# #     )#)    ###       #
#                   ######
#                   ######
#             ###   ######
#             ###        #
#             ###        #
#          )))###        #
#      B   ))*###        #
###     ##################