#####################   ##
#*)                    F #
#))        ###           #
#          #)#           #
#          ###      )))))#
# ))####            ######
# ))#))#                 #
# ))####                 #
# ))))~)                 #
#               #))))))))#
#               #))^)))))#
#                        #
#                        #
#  B                     #
###   ####################