#####################   ##
#         #))          N #
#         #))            #
#         ###            #
#                        #
#                        #
####      )))))$)))))))))#
####      )))))))))))))))#
#                        #
#                        #
####################     #
####################     #
#                        #
#           S            #
###########   ############