###    ###################
#  N       ##            #
#          ((            #
#          ((    ))      #
#          ##    ))      #
# #  #  #  ##    ##      #
#          ))    ##      #
#          )*    ((      #
#  #   #   ##    ((      #
#          ##    ##      #
#    #     ((    ##      #
#          ((    ))      #
#                ))      #
#                ##  B   #
#####################   ##