###     ##################
#  N        #            #
#           #            #
#           #            #
#           #            #
#)!))))))))))))))))))))))#
#                        #
#           #            #
#((                    ((#
#((                    ~(#
#########      ###########
#                 ##)))))#
#                 ##)))))#
#     B           ##)))))#
###    ###################