#####################   ##
#)^))#     )))        F  #
#))))#     )))           #
#    #     ))))))))))))))#
#    #       ))))))))))))#
#    #           )))     #
#    #           )))     #
#    #   ))))    )))     #
#    #   )##)    ))))))))#
#    #   )##)    ))))))))#
#        ))))            #
#                        #
#                     (((#
#     B               (*(#
###    ###################