##########################
#                    (((%#
                     ((-(#
 S                   ((((#
                         #
#                        #
#                        #
#                        #
#                        #
#                        #
#                         
#((((                   F 
#(%((                     
#-(((                    #
##########################